########################
#        ##            #
A  ###   ##  ########  #
######   ##        ##  #
#            ####  ##  B
########    ###    ##  #
##  ####       ##  ##  #
##  ####    #####  ##  #
##                ###  #
#####  ######    ###   #
#####  ######    ###   #
##               #     #
########################