########################
#        ##            #
A  ###   ##  ########  #
######   ##        ##  #
#            ####  ##  B
########     ####  ##  #
##    ####         ##  #
##  ####     ####  ##  #
##                 ##  #
#####  #######   ####  #
#####  #######   ####  #
##       ##      ####  #
########################