###                 #########
#   ###################   ###
# ####                # # ###
# ################### # # ###
#                     # # ###
##################### # # ###
#   ##                # # ###
# # ## ### ## ######### # ###
# #    #   ##B#         # ###
# # ## ################ # ###
### ##             #### # ###
### ############## ## # # ###
###             ##    # # ###
###### ######## ####### # ###
###### ####             #   #
A      ######################