########################
#        ##            #
A  ###   ##  ########  #
######   ##        ##  #
#            ####  ##  B
########     ####  ##  #
##    ####         ##  #
##  ####     ####  ##  #
##                     #
#####  #######   ####  #
#####  #######   #######
##       ##            #
########################